NO ./texture/minecraft(1).xpm
SO ./texture/nicpimp.xpm
WE ./texture/eagle.xpm
EA ./texture/nounours(1).xpm

F 220,100,0
C 225,30,0

        1111111111111111111111111111111111111111111111111
        1000000000110000000000000000000000000000000000001
        1011000001110000000000000000000000000000000000001
        1001000000000000000000000000000000000000000000001
        1001000000000000000000000000000000000000000000001
        1001000000000000000000000000000000000000000000001111111
        1001000000000000000000000000000000000000000000000000001
        1001000000000000000000000000000000000000000000001111101
        1001000000000000000000000000000000000000000000001   101
111111111011000001110000000000000000000000000000000000001   101
100000000011000001110111111111111110011111111111111111111   101
11110111111111011100000000000000000000000000000010001       101
11110111111111011100000000000000000000000000000010001       101
11110111111111011100000000000000000000000000000010001       101
11110111111111011100000000000000000000000000000010001       101
11110111111111011100000000000000000000000000000010001       101
11110111111111011100000000000000000000000000000010001       101
11110111111111011100000000000000000000000000000010001       101
11110111111111011100000000000000000000000000000010001       101
11110111111111011100000000000000000000000000000010001       101
11110111111111011100000000000000000000000000000010001       101
11110111111111011100000000000000000000000000000010001       101
11110111111111011100000000000000000000000000000010001       101
11110111111111011100000000000000000000000000000010001       101
11110111111111011101010000000000000000000000000010001       101
11000000110101011100000000000000000000000000000010001       101
10000100000000001100000000000000000000000000000010001       101
10000000000000001101010000000000000000000000000010001       101
11000001110101011111011110N000000000000000000000000011111111101
11110111 1110101 1011110100000000000000000000000000000000000001
11111111 1111111 1111111111111111111111111111111111111111111111