NO ./texture/minecraft.xpm
SO ./texture/minecraft.xpm
WE ./texture/eagle.xpm
EA ./texture/nounours.xpm

G ./weapon_sprites/fist.xpm ./weapon_sprites/fist2.xpm ./weapon_sprites/fist3.xpm
G ./weapon_sprites/gun.xpm ./weapon_sprites/gun2.xpm ./weapon_sprites/gun3.xpm ./weapon_sprites/gun4.xpm ./weapon_sprites/gun5.xpm ./weapon_sprites/handgun.xpm
G ./weapon_sprites/shotgun.xpm ./weapon_sprites/shotgun2.xpm ./weapon_sprites/shotgun3.xpm ./weapon_sprites/shotgun4.xpm ./weapon_sprites/gun5.xpm
G ./weapon_sprites/machinegun.xpm ./weapon_sprites/machinegun2.xpm ./weapon_sprites/chaingun.xpm



F 80,10,10
C 40,40,40

111111111111111111111111     111111111111111111111111
100000000000000000000001     100000000000000000000001
100000000000000000000001     100000000000000000000001
10000000000000000000000111111100000000000000000000001
1000N00000G000000000000000000000000000000000000000001
10000000000000000000000111111100000000000000000000001
100000000000000000000001     100000000000000000000001
100000000000000000000001     100000000000000000000001
111111111111111111111111     111111111111011111111111
                                        101
                                        101
                                        101
111111111111111111111111     111111111111011111111111
100000000000000000000001     100000000000000000000001
100000000000000000000001     100000000000000000000001
10000000000000000000000111111100000000000000000000001
10000000000000000000000000000000000000000000000000001
10000000000000000000000111111100000000000000000000001
100000000000000000000001     100000000000000000000001
100000000000000000000001     100000000000000000000001
111111111111111111111111     111111111111111111111111
