NO ./texture/minecraft(1).xpm
WE ./texture/eagle.xpm
EA ./texture/nounours(1).xpm
SO ./texture/nicpimp.xpm

F 80,10,10
C 40,40,40

     11222111111111111                                 11111111111111111
     100000100000000001               1               100000001000010001
     200000111111111101               1               101111101001010101
     2000002000000001001             101             1001000101001000101
     20000011101111D1D11             101             1000010101010100101
     10000000101001010001           10001           10101011101010101101
     11111110111101011101           10001           10001000100000001001
      100021D1000010000001         1000S01         11111111011111111101
      10100000101010111111         1011101         10000100010000000001
       11111100100100000001       100121001       10001000101011111111
       10000010000111111101       100101001       101D1111111000000001
        11010111100000001001     10000010201     10010000000011101101
        10010000110111100101     10111110101     10011111111002101001
         11110110100000101001   1001000000001   11111000000010010201
         10000110101001000101   11D1011011111   10000111111001010101
          101000001001001010011100010010000001110010000000101101001
          100110111111101001011101111011110101110111011000000001001
           1010100000001010100100100000001010010001010111111111101
           1000101011101010110101001222200012210111010100000000001
            11000100010000001000100000011111000010101010111111101
            10011111011111110121001111001000011110001010000001001
             100010001000000010100000010001000010101001111100101
             101000101011111100011111111111101010101011000001001
              11011111000000001010000000000011000101001D1111101
              1000000011101101110001111111100011000000010100001
               11111100211000100011        1100011111111010101
               100000000000100011            11000000000010001
               1111111111111111                111111111111111